00,00,00,00,00,00,99,04,01,05
00,00,00,00,00,00,00,02,00,02
00,00,99,00,00,01,00,02,00,02
04,01,01,01,01,01,01,03,01,03
02,00,00,00,02,00,00,00,00,00
06,01,01,01,03,00,00,00,00,00